%%%%%%%%%%%%%%%%%%%%%%%%%%%%%%%%%%%%%%%%%%%%%%%%
%                                             P%
%                                              %
%                                              %
%                                              %
%                                              %
%                                              %
%                                              %
%                                              %
%                                              %
%                                              %
%                                              %
%                                              %
%                                              %
%                                              %
%                                              %
%                                              %
%                                              %
%                                              %
%                                              %
%                                              %
%                                              %
%                                              %
%                                              %
%                                              %
%                                              %
%                                              %
%                                              %
%                                              %
%                                              %
%                                              %
%.                                             %
%%%%%%%%%%%%%%%%%%%%%%%%%%%%%%%%%%%%%%%%%%%%%%%%
